WE  data/texture/wall_west.xpm
NO  data/texture/wall_north.xpm
SO  data/texture/wall_south.xpm
EA  data/texture/wall_east.xpm


F 20,20,20
C 200,200,200

11111
10001
10001
10N01
10001
10001
10001
10s01
1000111
1000D01
1000111
1111111