NO tester_cub3D/data/texture/wall_north.xpm
SO tester_cub3D/data/texture/wall_south.xpm
WE tester_cub3D/data/texture/wall_west.xpm
EA tester_cub3D/data/texture/wall_east.xpm

F 20,20,20
C 200,200,200

111111111111111111111111111
1CD0000000000000000000000C1
111000000000000000011111101
1000000000000X0000001111101
10000C000000000000000111101
100000000000000000000001101
110000000000000000000000001
11100000000001110000C000001
11000000000001C100000000111
10000010000001D100000001111
100011110000000000000000111
100011111000000000000000001
1000011100000s0000001000001
100000100000000000011100001
100000000000000000001100C01
100C000000000N00000011000011111
10000000000000000000000000D00C1
1111111111111111111111111111111
